-17
20
-9
8
00000000000000000000000000000000000000
11111111111111111111111111111111111110
10000000000000000000000000000000000010
10000000000000000000000000000000000010
10000000000000000000000000000110000010
10000000000000000000000000000000000010
10000000000000000000000111111100000010
10000000000000000000000111111100000010
10000000001000000000000111111100000010
10000000000000000000000111111100000010
10000000000000000000000111111100000010
10000000000000000000000111111100000010
10000000000000000000000111111100000010
10000000000100000000000000000000000010
10000000000000000000000000000000000010
10000000000000000000000000000000000010
10000000000000000000000000000000000010
11111111111111111111111111111111111110
